00000000000000000002222222000
00000000000000000002111212000
00000000000000000002121212000
00000000000000000002121112000
00000000000000000000000000000
00000000000000000000000000000
00000000000000000000300000000
00000000000000000002420000000
00000000000000000002120000000
00000000000222220022120000000
00000000000201110111120000000
00000000000207000022220000000
00000000000206000000000000000
00000000000000000000000000000
00000000000000000000000000000
22222222222222222222222222222
00000000000000000000000000000
00000000000000000000000000000
00000000000000000000000000000
00000000000000000000000000000
00000000000000000000000000000
00000000000000000000000000000
00000000000000000000000000000
00000000000000000000000000000
00000000000000000000000000000
00000000000000000000000000000
00000000000000000000000000000
00000000000000000000000000000
00000000000000000000000000000
25