00000000020000000020000000000
00000000020000000020000000000
00000000020000000020000000000
00000000020000000020000000000
00000000020000000020000000000
00000000020000000020000000000
00000000020000000020000000000
00000000020000000020000000000
00000000020000000020000000000
00000000020000000020000000000
00000000020000000020000000000
00000000020000000020000000000
00000000020000000020000000000
00000000020000000020000000000
00000000020000000020000000000
00000000020000000020000000000
00000000020000000020000000000
00000000020000000020000000000
00000000020000000020000000000
00000000020000000020000000000
00000000020000000020000000000
00000000020000000020000000000
00000000020000000020000000000
00000000020000010020000000000
00000000020000000020000000000
00000000020000070020000000000
00000000020000060020000000000
00000000020000000020000000000
00000000020000000020000000000
115