00000000200000000000200000000
00000000200000000000200000000
00000000200000000000200000000
00000000200011110000200000000
00000000200011110000200000000
00000000200011110000200000000
00000000200011110000200000000
00000000200011110000200000000
00000000200000000000200000000
00000000200070000000200000000
00000000200060000000200000000
00000000200000000000200000000
00000000200000000000200000000
00000000200000000000200000000
00000000222222222222200000000
00000000000000000000000000000
00000000000000000000000000000
00000000000000000000000000000
00000000000000000000000000000
00000000000000000000000000000
00000000000000000000000000000
00000000000000000000000000000
00000000000000000000000000000
00000000000000000000000000000
00000000000000000000000000000
00000000000000000000000000000
00000000000000000000000000000
00000000000000000000000000000
00000000000000000000000000000
17