00000000000000000000000000000
00000000000000000000000000000
00000000000000000000000000000
00000000000000000000000000000
00000000022222222222222200000
00000000020000000000000200000
00000000020000000000000200000
00000000020000000000000200000
00000000020000000000000200000
00000000020000000000000200000
00000000020000000000000200000
00000000020000000000000200000
00000000020000000000000200000
00000000020000000000000200000
00000000020000000000000200000
00000000020000000000000200000
00000000020000000000000200000
00000000020000000000000200000
00000000020000000000000200000
00000000020000000000000200000
00000000020000000000000200000
00000000020000033000000200000
00000000020000000000000200000
00000000020000000000000200000
00000000000000000000000000000
00000000000000070000000000000
00000000000000060000000000000
00000000000000000000000000000
00000000000000000000000000000
5