00000000200000000000020000000
00000000200000000000020000000
00000000200000000000020000000
00000000200000000000020000000
00000000200000000000020000000
00000000200444444000020000000
00000000200411114000020000000
00000000200411114000020000000
00000000200411114000020000000
00000000200411114000020000000
00000000200444444000020000000
00000000200000000000020000000
00000000200070000000020000000
00000000200060000000020000000
00000000200000000000020000000
00000000222222222222220000000
00000000000000000000000000000
00000000000000000000000000000
00000000000000000000000000000
00000000000000000000000000000
00000000000000000000000000000
00000000000000000000000000000
00000000000000000000000000000
00000000000000000000000000000
00000000000000000000000000000
00000000000000000000000000000
00000000000000000000000000000
00000000000000000000000000000
00000000000000000000000000000
17