00000000000000000000000000000
00000002222200000000000000000
00000002111222200000000000000
00000002111242200000000000000
00000002111414200000000000000
00000002222242220000000000000
00000000000211120000000000000
00000000000211120000000000000
00000000000211120000000000000
00000000000224220000000000000
00000000000000000000000000000
00000000000007000000000000000
00000000000006000000000000000
00000000000000000000000000000
22222222222222222222222222222
00000000000000000000000000000
00000000000000000000000000000
00000000000000000000000000000
00000000000000000000000000000
00000000000000000000000000000
00000000000000000000000000000
00000000000000000000000000000
00000000000000000000000000000
00000000000000000000000000000
00000000000000000000000000000
00000000000000000000000000000
00000000000000000000000000000
00000000000000000000000000000
00000000000000000000000000000
25