00200020000200000000000000000
00020002000020000000222220000
01002002010002000000211120000
00000202010200200000211120000
01011022030220020000211120000
01001102040202002222242220000
01020110010200201111112000000
05002011010200022222222000000
01000200000200000000000000000
01000222222200000000000000000
00002000000000000000000000000
07002000000000000000000000000
06002000000000000000000000000
00002000000000000000000000000
22222000000000000000000000000
00000000000000000000000000000
00000000000000000000000000000
00000000000000000000000000000
00000000000000000000000000000
00000000000000000000000000000
00000000000000000000000000000
00000000000000000000000000000
00000000000000000000000000000
00000000000000000000000000000
00000000000000000000000000000
00000000000000000000000000000
00000000000000000000000000000
00000000000000000000000000000
00000000000000000000000000000
50