00000000000200000000000000000
00000000000211040113115111102
00000022222242222222222220102
00000020102002000000000020102
00000021112002000000000020102
00000020104012000000000020302
00000024222222000000000020102
00000220200000000000000020102
00000230222220000000000020502
00000210401020000000000020102
00000222211120000000000020102
00000000201022222000000020102
00000000224220102000000020002
00000000020041112000000020702
00000000021020102000000020602
00000000022222242200000020002
00000000222222200200000022222
00000000200100401200000000000
00000000200100222200000000000
00000000211311200000000000000
00000000200100200000000000000
00000000200100200000000000000
00000000222222200000000000000
00000000000000000000000000000
00000000000000000000000000000
00000000000000000000000000000
00000000000000000000000000000
00000000000000000000000000000
00000000000000000000000000000
100