00000000000000000000000000000
00000000000000000000000000000
00000000000000000000000000000
00000000000000444444000000000
00000000011110411114000000000
00000000000000444444000000000
00000000700000000000000000000
00000000600000000000000000000
00000000000000000000000000000
00000000000000000000000000000
22222222222222222222222222222
00000000000000000000000000000
00000000000000000000000000000
00000000000000000000000000000
00000000000000000000000000000
00000000000000000000000000000
00000000000000000000000000000
00000000000000000000000000000
00000000000000000000000000000
00000000000000000000000000000
00000000000000000000000000000
00000000000000000000000000000
00000000000000000000000000000
00000000000000000000000000000
00000000000000000000000000000
00000000000000000000000000000
00000000000000000000000000000
00000000000000000000000000000
00000000000000000000000000000
15