00000020000000000000000000000
00000021111050030040011110000
00000023222222222222222250000
00000110111200000000211111110
00000021221200000000212212010
00000021221222000022232212010
00000021151112000021111112010
00000022221112000021112222010
00000000021112000021112002070
00000000022222000022222002060
00000000000000000000000002000
00000000000000000000000002222
00000000000000000000000000000
00000000000000000000000000000
00000000000000000000000000000
00000000000000000000000000000
00000000000000000000000000000
00000000000000000000000000000
00000000000000000000000000000
00000000000000000000000000000
00000000000000000000000000000
00000000000000000000000000000
00000000000000000000000000000
00000000000000000000000000000
00000000000000000000000000000
00000000000000000000000000000
00000000000000000000000000000
00000000000000000000000000000
00000000000000000000000000000
50