00000000000000000000022220000
00000000000022222222221120000
00000000000020000000041120000
00000000000021222222224220000
00000000000020200211400020000
00000000000020200210000020000
00022222222220202240000020000
00024110040410202110000020000
00022221222222202100000020000
00000024200000002400000020000
00000020200000002100000022222
00222220200000002114000000000
00200001200000002222222220000
00202222222222222000000020700
00212200411411411220000020600
00252202222222221222222220000
00212232000000021211111112222
00212212000000021212222212000
00252212000000021212111212000
00212252000000021212121212000
00212212000000021212121212000
00232212000000021212221212000
00202252000000021211111212000
00242212000000021222222212000
00212212000000021311111112000
00211112000000022222222222000
00222222000000000000000000000
00000000000000000000000000000
00000000000000000000000000000
100