00000000000000000000000000000
00000000000000000000000000000
00000000000000000000202002222
00000000000000000002424222112
00000000000000000024141401112
00000000000000000002424222522
00000000200000000222022222420
00000002420000000211120024142
00000024142222222211120002420
00000241001003004011120224142
00000024142222222222220200400
00000002420000000000000200000
00000002120000000000000200700
00000002120000000000000200600
00000002420000000000000200000
00000024142222222222220222222
00000241001004004011120000000
00000024142222222211120000000
00000002420000000211120000000
00000000200000000222022000000
00000000000000000002424222222
00000000000000000024141401112
00000000000000000002424221112
00000000000000000000202021112
00000000000000000000000022222
00000000000000000000000000000
00000000000000000000000000000
00000000000000000000000000000
00000000000000000000000000000
100