00000000000000000000000000000
00000000000000000000000000000
00000000000000000000000000000
00000000000002222222000000000
00000000000002000002002222222
00000000022222421002021340100
00000000020000321002021020100
00000000201101121002211220100
00000002550222221002112020100
00000020152200021341120020100
00000201020000022222200020100
00002010200000000000000020000
00020102000000000000000020700
00201020000000000000000020600
00200200000000000222222020000
00212222200000000214012022222
00211501200000000212212000000
00222224200000222212212000000
00000021222222213114112000000
00000021401002212202222000000
00000022222212202242000000000
00000000000214011112000000000
00000000000222222222000000000
00000000000000000000000000000
00000000000000000000000000000
00000000000000000000000000000
00000000000000000000000000000
00000000000000000000000000000
00000000000000000000000000000
100