00000002000000000000020000000
00000002000030011110020000000
00000002022222222222120222222
00000002111200000002120245014
00000002111200000002122222112
00000002111200000002111102202
00000002022200000002222202202
00000002320000000000000232202
00000002020000000000000202202
00000002120000000000000212202
00000002020000000000000212212
00000002420000000000000212212
00000002020000000000000200010
00000002120000000000000210070
00000002120000000000000211060
00000002120000000000000220000
00000002220000000000000022222
00000000000000000000000000000
00000000000000000000000000000
00000000000000000000000000000
00000000000000000000000000000
00000000000000000000000000000
00000000000000000000000000000
00000000000000000000000000000
00000000000000000000000000000
00000000000000000000000000000
00000000000000000000000000000
00000000000000000000000000000
00000000000000000000000000000
50