00000000000000000000000000000
00000000000000000000000000000
00000000000000000000000000000
00000000000000000000000000000
00000000022222222222222200000
00000000021111110111111200000
00000000021111110111111200000
00000000021111110111111200000
00000000021111110111111200000
00000000021111110111111200000
00000000021111110111111200000
00000000021111110111111200000
00000000021111110111111200000
00000000021111110111111200000
00000000021111110111111200000
00000000021111110111111200000
00000000021111110111111200000
00000000021111110111111200000
00000000021111110111111200000
00000000021111110111111200000
00000000021111110111111200000
00000000021111110111111200000
00000000021111110111111200000
00000000021111110111111200000
00000000000000000000000000000
00000000000000070000000000000
00000000000000060000000000000
00000000000000000000000000000
00000000000000000000000000000
15