00000000000000000000000000000
00000000000000000000000000000
00000000000000000000000000000
00000000000000000000000000000
00000000000000000000000000000
00000000000000000000000000000
00000000000000000000000000000
00000000000000000000000000000
00000000000000000000000000000
00000000000000000000000000000
00000000000000000000000000000
00000000000000000000000000000
00000000000000000000000002060
00000000000000000000000002070
00000000000000000000000002010
00000000000000000000000002010
00000000000000000000000002000
00000000000000000000000002555
00000000000000000000000002010
00000000000000000000000002010
00000000000000000000000002010
00000000002222200000000002555
00000000002111200000000002555
00000000002111200000000002000
00000000002111200000000002010
00000000002225200000000002010
00000000000021222222222222010
00000000000021001111100511110
00000000000020000000000000000
30