00020000200002002000002000000
00002000200000200200000200000
00000200201000020020000020000
00000020201002002002000002000
00101102201002200201111100200
00100110201002220021111100020
00100011001002022011111100002
00100001101002002201111100000
00300200000002000221111120000
00000220001002000022002002000
00100202000002000002200200200
00100200200002000000220020020
00400200022222000000022220002
00000200000000000000000027000
00100200000000000000000026000
00100222222220000000000020000
00113040111020000000000022222
22222222222220000000000000000
00000000000000000000000000000
00000000000000000000000000000
00000000000000000000000000000
00000000000000000000000000000
00000000000000000000000000000
00000000000000000000000000000
00000000000000000000000000000
00000000000000000000000000000
00000000000000000000000000000
00000000000000000000000000000
00000000000000000000000000000
60