22222222222222222000000000000
01111000000021112000000000000
00021000000021212000000000000
01024000000021232222200000000
01021000000000211411200000000
01021000000001211223200000000
07021000000001222200000000000
06021112220001200001100000000
00022211311400200001100000000
22220222222222200000000000000
00000000000000000000000000000
00000000000000000000000000000
00000000000000000000000000000
00000000000000000000000000000
00000000000000000000000000000
00000000000000000000000000000
00000000000000000000000000000
00000000000000000000000000000
00000000000000000000000000000
00000000000000000000000000000
00000000000000000000000000000
00000000000000000000000000000
00000000000000000000000000000
00000000000000000000000000000
00000000000000000000000000000
00000000000000000000000000000
00000000000000000000000000000
00000000000000000000000000000
00000000000000000000000000000
36