00000000200000000002000000000
00000000200000000002000000000
00000000200000000002000000000
00000000200011100002000000000
00000000200011100002000000000
00000000200011100002000000000
00000000200000000002000000000
00000000200010000002000000000
00000000200010000002000000000
00000000200010000002000000000
00000000200070000002000000000
00000000200060000002000000000
00000000200000000002000000000
00000000200000000002000000000
00000000222222222222000000000
00000000000000000000000000000
00000000000000000000000000000
00000000000000000000000000000
00000000000000000000000000000
00000000000000000000000000000
00000000000000000000000000000
00000000000000000000000000000
00000000000000000000000000000
00000000000000000000000000000
00000000000000000000000000000
00000000000000000000000000000
00000000000000000000000000000
00000000000000000000000000000
00000000000000000000000000000
15