00000000000000000000000000000
00000000000000000000000000000
00000000000000002222200000000
00000000000000002111200000000
00000000000000222141200000000
00000000000000211111200000000
00000000000000212122200000000
00000000000000222120000000000
00000000011101111120000000000
00000000000000222220000000000
00000000700000000000000000000
00000000600000000000000000000
00000000000000000000000000000
00000000000000000000000000000
22222222222222222222222222222
00000000000000000000000000000
00000000000000000000000000000
00000000000000000000000000000
00000000000000000000000000000
00000000000000000000000000000
00000000000000000000000000000
00000000000000000000000000000
00000000000000000000000000000
00000000000000000000000000000
00000000000000000000000000000
00000000000000000000000000000
00000000000000000000000000000
00000000000000000000000000000
00000000000000000000000000000
25