00000000000000000000000000000
00000000000000000000000000000
00022222222222222222222222222
00021100300111000041200001112
00021222222222222220120001012
00021511311311120002012000242
00022222222222420000201223202
00000000000002120000020120202
00022222222222120000002001002
00021111151103120000002220222
00021222222222220000000020000
00024222222222000000000020000
00021000000002000000000020700
00020000000002220000000020600
00022222222444420000000020000
00000000002111420000000022222
00000000002131420000000000000
00000000002111420000000000000
00000000002444420000000000000
00000000022241420000000000000
00000000024444420000000000000
00000000024111420000000000000
00000011024131420000000000000
00000011004111420000000000000
00000000024444420000000000000
00000000022222220000000000000
00000000000000000000000000000
00000000000000000000000000000
00000000000000000000000000000
100