00000000000000000000000000000
00000000000000000000000000000
00000000000000000000000000000
00000000000000000000000000000
00000000000000000000000000000
00000000000000000000000000000
00000000000000000000000000000
00000000000000000000000000000
02222222222222222222222220000
02104102011050103000041120000
02102002002222222222222122222
02102302030200000000024444442
02222102221200000000024141142
00002110021222000000024441142
00002222021002000000022244442
00000002421002000000000222022
00000002121002000000000200100
00000002114012000000000200100
00000002220212000000000200100
00000000021112000000000200700
00000000022222000000000200600
00000000000000000000000200000
00000000000000000000000222222
00000000000000000000000000000
00000000000000000000000000000
00000000000000000000000000000
00000000000000000000000000000
00000000000000000000000000000
00000000000000000000000000000
50