00000000000000002222222222222
00000000000000002000050003000
00000000000000002111151113110
00000000000000002100050003010
00000000000000002122222222000
00000000000000002151131122444
00000000000000002222222122010
00000000000000000000002422010
00000000000000022222222122010
00000000000000021151103122010
00000000000000021222222222070
00000000000000021200000002060
00000000000000024200000002000
00000000000000020200000002222
00000000000000021200000000000
00000000000000021200000000000
00000000000000021200000000000
00000000000000021200000000000
00000000000002224222000000000
00000000000002000002000000000
00000000000002041402000000000
00000000000002013102000000000
00000000000002041402000000000
00000000000002000002000000000
00000000000002222222000000000
00000000000000000000000000000
00000000000000000000000000000
00000000000000000000000000000
00000000000000000000000000000
50