22200000000000022200000000000
41100300000111041200000000000
22202222222222221200000000000
02111120000000024222220000000
22111120000000021114122222222
20111120000000022222122103110
20222220000000000002422402010
20200000000000000002122102010
20200000000000000002141102010
20200000000000000002222222000
20222222000000000000000002070
21400002000000000000000002060
21400032000000000000000002000
21222212000000000000000002222
20200201200000000000000000000
20200020120000000000000000000
20200002012000000000000000000
20220020112000000000000000000
20022223222200000000000000000
20154020111200002222222222000
22222220131200002140301112000
00000022111200002122222242000
00000002242200002121111202000
00000000212000002121222232000
00000000242000002121304102000
00000000202000002122222222000
00000000212222222420000000000
00000000213114011120000000000
00000000222222222220000000000
100