00000000000000000000000000000
00000000000000000000000000000
00000000000000000000000000000
00000000000000000000000000000
00000000000000000000000000000
00000000000000000000000000000
00000000000000000000000000000
00000000000000000000000000000
00000000000000000000000000000
00000000000000000000000000000
00000000000000000000000222000
00000000000000000000000212000
00000000000000000000000212000
00000000000000000000222242222
00000000000000000000211111110
00000000000000000000234412010
00000000000000000000214412010
00000000000000000000211112000
00000000000000000000222222333
00000000000000000000000002010
00000000000000000000000002000
00000000000000000000000002333
00000000000000000000000002010
00000000000000000000000002010
00000000000000000000000002444
00000000000000000000000002010
22222222222222222222222222010
00000000000000000000067041110
00000000000000000000000004444
30