00000000000000000000200000000
00000000000000000000211111110
00000000000000000000212222010
00000000000000000000212002010
00000000000000000000242002010
00000000000002222222252222010
00000000000002111110411112000
00000000000002122222211112070
00000000000002120000211112060
00000000000000200000222222000
00000000000000000000000002222
00000000000000000000000000000
00000000000000000000000000000
00000000000000000000000000000
00000000000000000000000000000
00000000000000000000000000000
00000000000000000000000000000
00000000000000000000000000000
00000000000000000000000000000
00000000000000000000000000000
00000000000000000000000000000
00000000000000000000000000000
00000000000000000000000000000
00000000000000000000000000000
00000000000000000000000000000
00000000000000000000000000000
00000000000000000000000000000
00000000000000000000000000000
00000000000000000000000000000
35