00000000222200222220000000000
00000000211100041120000000000
00000000222200041120000000000
00000000222200222220000000000
00000000211100000000000000000
00000000211100111000000000000
00000000222200000000000000000
00000000000000007000000000000
00000000000000006000000000000
00000000000000000000000000000
22222222222222222222222222222
00000000000000000000000000000
00000000000000000000000000000
00000000000000000000000000000
00000000000000000000000000000
00000000000000000000000000000
00000000000000000000000000000
00000000000000000000000000000
00000000000000000000000000000
00000000000000000000000000000
00000000000000000000000000000
00000000000000000000000000000
00000000000000000000000000000
00000000000000000000000000000
00000000000000000000000000000
00000000000000000000000000000
00000000000000000000000000000
00000000000000000000000000000
00000000000000000000000000000
25