00000000020000000020000000000
00000000020000000020000000000
00000000020000000020000000000
00000000020000000020000000000
00000000020000100020000000000
00000000020000100020000000000
00000000020000100020000000000
00000000020000100020000000000
00000000020000000020000000000
00000000020000000020000000000
00000000020000000020000000000
00000000020001000020000000000
00000000020001000020000000000
00000000020001000020000000000
00000000020007000020000000000
00000000020006000020000000000
00000000020000000020000000000
00000000020000000020000000000
00000000020000000020000000000
00000000022222222220000000000
00000000000000000000000000000
00000000000000000000000000000
00000000000000000000000000000
00000000000000000000000000000
00000000000000000000000000000
00000000000000000000000000000
00000000000000000000000000000
00000000000000000000000000000
00000000000000000000000000000
15