00000000000000000000000000000
00000000000000000000000000000
00000000000000000000000000000
00000000000000444440000000000
00000000011101111140000000000
00000000000000444140000000000
00000000700000444140000000000
00000000600000411140000000000
00000000000000444440000000000
00000000000000000000000000000
00000000000000000000000000000
00000000000000000000000000000
00000000000000000000000000000
00000000000000000000000000000
22222222222222222222222222222
00000000000000000000000000000
00000000000000000000000000000
00000000000000000000000000000
00000000000000000000000000000
00000000000000000000000000000
00000000000000000000000000000
00000000000000000000000000000
00000000000000000000000000000
00000000000000000000000000000
00000000000000000000000000000
00000000000000000000000000000
00000000000000000000000000000
00000000000000000000000000000
00000000000000000000000000000
17