00000000020000000200000000000
00000000020000000200000000000
00000000020000000200000000000
00000000020001000200000000000
00000000020001000200000000000
00000000020001000200000000000
00000000020001000200000000000
00000000020001000200000000000
00000000020000000200000000000
00000000020001000200000000000
00000000020001000200000000000
00000000020001000200000000000
00000000020007000200000000000
00000000020006000200000000000
00000000020000000200000000000
00000000020000000200000000000
00000000020000000200000000000
00000000020000000200000000000
00000000022222222200000000000
00000000000000000000000000000
00000000000000000000000000000
00000000000000000000000000000
00000000000000000000000000000
00000000000000000000000000000
00000000000000000000000000000
00000000000000000000000000000
00000000000000000000000000000
00000000000000000000000000000
00000000000000000000000000000
15