00000000000000000000000000000
00000000222222222222222000000
00000000211110050031112000000
00000000211112222222202222222
00000000211112000000210101014
00000000211112000000202022222
00000000211112000000210101014
00000222242222000000222022222
00000211111112000000002101014
00000211111112000000002220202
00000211111112000000000021014
00000211111112000000000022202
00000222242222000000000020000
00000000202000000000000020700
00000000232000000000000020600
00000000232000000000000020000
00000000202222222220000022222
00000000200000000020000000000
00000000204140414020000000000
00000000201010101020000000000
00000000204140414020000000000
00000000200000000020000000000
00000000222222222220000000000
00000000000000000000000000000
00000000000000000000000000000
00000000000000000000000000000
00000000000000000000000000000
00000000000000000000000000000
00000000000000000000000000000
100